  ####      ########
  #  ##### ##   #  #
  #    $ ### $  $  #
  #  $ # ##    $   ####
  ###  #    # ###$##  #
#####  ###  ####   $  #
#   # $  $$## .. ##$  #
#  $$   # $          ##
##  # $##  #### # ####
### #  ##$ ###..#..#
#   ###..  #  .....###
#   #  *.### #  #..  #
##$$#  *.##@ #  #    #
 #     *. ####  ###  #
 ######   #  #       #
      #####  ##    ###
              #  ###
              ####