   #####
   #   #####
   # $$#   ######
 ###.  . $ #    #
 #  .##.####### #
 # $.  . #    # #
##.##$$$$#$$$ ######
 #...    .    #    #
 #..##.####.### ##@#
 ## # $ $ $ # $ $  #
  # #       #     ###
  # #.##.#.######  #
  #  $ # $.     $  #
  #    ###.## ###$##
  ###### #        #
         ##########