   ##### ####
   #@ .###  ###
####  $$ $    #
#   # . . ##  #
#  $ # . . ## #
## .  $ $$  # #
 # #  ###.  # #
 # #### ##### #
 #       #    #
 ####### # ####
       # .$ #
     ####   #
     ## #####
      ###