##### ########
#   ### . $  #
#   $ *.. #$ ##
## $# ..* $  @#
 #  $ . ###   #
 ######## #####