  #####       #########
  #   #       #       #
### #$### ##### # # # #####
# $. .  # #    . . . .    #
# # # #$### # # # # # # #$#
#  . . . .  $ $ $ $  . .  #
###$# # #$###########$# #$#
  #  . .  ##        #  .  #
  ###$# #$####### # #$# #$###
    #  . .$ $ $ #   #  . .  #
    #$# # # # # #####$# # # #
    #  . . . . .  $  . . .  #
    ### # # # # # # # # # # #
      # $ $. . .$ $ $ $ $ $ #
      ##### # # #############
          #  @  #
          #######