#########
#       #    ######
#   $   ######    ###
# #$#$ $ $  # $     #
# $   $@$  $ $ $ $$ #
# $ $# $ #     $$$  #
#  $ $ #######   #####
##    ###....##### ..#
 ###$$# $$$$ #...* ..#
  #         ##   #.. #
  #  #  #$###....##*##
  #   ##..$. ....    #
  ### .*   .#....#   #
    ##################