  ###########
###.  .$.  .###
 ## $  $  $ ##
  ## ..$.. ##
   ##$#$#$##
    #.$ $.#
    #  @  #
    ### ###
   ## $ $ ##
   #.  $  .#
   ### . ###
     #####