                      ####
  ####         ########  #
###@ ##        #      #  #
#     #        # ### $ $ #
# ....##########   #  #..#
# . #  ## $   $ $# #  #..#
### #     $  $$$ # # $ $ #
  # ...# $  $$   # #  #  #
  #  ..# $   $ $ # # ##  #
  ##...#  $ $$ $ #$# #####
   #   ## $  $ $   # #
   ### ######  ### # ###
   # .   ## #### .   . #
  ##   . #     # #.#.# #
  #  .   # # # #   #   #
  # . ####     #########
  #  ##
  ####