           ####
 ###########  #
 #  $ $ $ $   ##
 #  # # # # #$##
 ##. . . . . .#
  #$# # # # #$####
###. . . . . .   #
###$# # # # # @  #
  #   $ $ $ $  ###
  #  ###########
  ####