        ######
        #   ##
  ####### $  #
  # $ $ $ #$ #
  #   #. $   #
 ####.#.# $###
 #   ..... #
 #  $ ..##$#
### ## ..  #
#  $.#$ # $#
#   $   #  #
##@  #  ####
 ##  ####
  ####