   ####
   #@ #
  ##  ##
  # .$#####
  #$. #   #
###..$# # #
#  ..$  $ #
# $ $ # ###
##### # #
    #   #
    ###.#
      ###