    ####
#####  #
#      #
#$ $ $ #
#.*.*.*#
#*.*.*.#
# $ $ $#
#......#
#.*.*.*#
#$ $ $ #
# $ $ $#
#$ $ $ #
#      #
#@ #####
####