#####
#   ####
# # # .#
#    $ ###
### #$.  #
#   #@   #
# # ######
#   #
#####