####  ####
#  ####  #
#  #  #  #
#  #    $##
#  . .#$  #
#@ ## # $ #
#   . #   #
###########