#######
#     #
# .$. #
# $#$ #
# .#. #
# $.$ #
#  @  #
#######
