# #####
  #   #
###$$@#
#   ###
#     #
# . . #
#######