#######
#  @  #
# .$. #
# $#$ #
# .#. #
# $.$ #
#     #
#######
