 ####
 #  ####
 #     ##
## ##   #
#. .# @$##
#   # $$ #
#  .#    #
##########