 #####
 # @ #
 #   #
###$ #
# ...#
# $$ #
###  #
  ####