    #######
   #   ## .##
###  $   ...#
#   $$$ #..#
# $$@ ##.#.#
# # $$#  $.#
###     $# #
  ####    .#
     #######