   #######
 ##   #  .#
#   $   #.#
#  $#$  #.#
# $@  #.#.#
# $$$# .$.#
##     $# #
 ####   ..#
    #######