    ####
   #   ######
###  $    ..#
#   $$$ $..##
# $$@ $$.$.##
# # $$$ $..##
###     .$..#
  ####  ....#
     ########