######
#+   #
# ## #
# #$ #
#    #
######
