##########
#i!!i#i!i#
#!$ o o !#
#i oo @ i#
###ii#####
  ####

