##########
#! .!#!!!#
#!$     !#
#!    @ !#
###!!#####
  ####

