##########
#  . #   #
# $      #
#     @  #
###  #####
  ####

