##########
#! .!#!!!#
#!$ o o !#
#! oo @ !#
###!!#####
  ####
