########
#56#656#
#4#.#4##
#32123#
##3#@#
 #####

