########
#@     #
# *$$. #
# $..  #
# *$ . #
# $..  #
# *$$. #
#      #
########
