########
#@     #
# $..$ #
# * $. #
# *$ . #
# * $. #
# $..$ #
#      #
########