########
#@     #
#  $$  #
# *  * #
# *. * #
# * .* #
# .$$. #
#      #
########