########
#@     #
# *  * #
# $*.$ #
# * $* #
# $..$ #
# .  . #
#      #
########