########
#@     #
# ..   #
# $. $ #
# $* $ #
# $.$* #
# *..* #
#      #
########