########
#@     #
# $$.  #
# $.$. #
# $*.. #
# $.$. #
# $* . #
#      #
########