########
#@     #
# .$$. #
# * .$ #
# *. $ #
# * .$ #
# .$$. #
#      #
########