   Depth            BFSolver                A(i)                A(c)           A(+{c,i})         A(+{c,i,4})    A(+{*{i,i},c,4})    A(+{*{s,s},c,4})A(+{*{B,B,s,s},c,4})A(+{*{B,B,a,a},c,4})             A(rand)
       1                    0                   1                   1                   1                   1                   1                   1                   1                   1                   1
       2                    5                  18                  15                  18                  18                   5                   5                   5                   5                   5
       3                   18                  91                  54                  91                  91                   9                   9                   8                  14                  11
       4                   57                1192                 166                1192                1192                  15                  15                  11                  17                  27
       5                  159                3907                 447                3907                3901                  20                  20                  15                  21                  92
       6                  413                8901                1136                8901                8803                  23                  23                  21                  27                  95
       7                  995                9189                2754                9189                8831                  27                  27                  26                  42                 100
       8                 2326                9248                6443                9293                8922                  33                  33                  29                  47                 107
       9                 5209                9112                9767                9112                9014                  47                  47                  33                  51                 104
      10                11511                9051                   0                9051                8953                  58                  58                  39                  54                 109
      11                24673                9183                   0                9183                9085                  61                  61                  49                  59                 115
      12                29879                8897                   0                8897                8799                  66                  66                  64                  69                 118
      13                    0                   0                   0                   0                   0                  68                  68                  67                  72                 130
      14                    0                   0                   0                   0                   0                  71                  71                  70                  75                 135
      15                    0                   0                   0                   0                   0                  79                  79                  77                  83                 167
      16                    0                   0                   0                   0                   0                  88                  88                  86                  91                 170
      17                    0                   0                   0                   0                   0                 104                 104                  90                 102                 180
      18                    0                   0                   0                   0                   0                 107                 107                  94                 112                3582
      19                    0                   0                   0                   0                   0                 113                 113                  96                 125                3584
      20                    0                   0                   0                   0                   0                 117                 117                  98                 139                3587
      21                    0                   0                   0                   0                   0                 121                 121                 103                 151                2786
      22                    0                   0                   0                   0                   0                 126                 126                 113                 154                3573
      23                    0                   0                   0                   0                   0                 128                 128                 116                 162                3631
      24                    0                   0                   0                   0                   0                 131                 131                 119                 174                3634
      25                    0                   0                   0                   0                   0                 134                 134                 127                 178                3638
      26                    0                   0                   0                   0                   0                 158                 158                 138                 182                3641
      27                    0                   0                   0                   0                   0                 160                 160                 156                 187                3924
      28                    0                   0                   0                   0                   0                 165                 165                 159                 190                3926
      29                    0                   0                   0                   0                   0                 170                 170                 165                 194                3715
      30                    0                   0                   0                   0                   0                 172                 172                 169                 199                4087
      31                    0                   0                   0                   0                   0                 177                 177                 171                 206                4105
      32                    0                   0                   0                   0                   0                 181                 181                 174                 209                4135
      33                    0                   0                   0                   0                   0                 188                 188                 178                 213                4136
      34                    0                   0                   0                   0                   0                 196                 196                 183                 221                4146
      35                    0                   0                   0                   0                   0                 202                 202                 185                 229                4273
      36                    0                   0                   0                   0                   0                 211                 211                 188                 232                5377
      37                    0                   0                   0                   0                   0                 217                 217                 192                 236                5379
      38                    0                   0                   0                   0                   0                 228                 228                 201                 240                4336
      39                    0                   0                   0                   0                   0                 245                 245                 206                 246                4342
      40                    0                   0                   0                   0                   0                 290                 290                 208                 249                4387
      41                    0                   0                   0                   0                   0                 328                 328                 213                 251                8547
      42                    0                   0                   0                   0                   0                 330                 330                 215                 252                8552
      43                    0                   0                   0                   0                   0                 333                 333                 223                 255                8644
      44                    0                   0                   0                   0                   0                 335                 335                 232                 259                8575
      45                    0                   0                   0                   0                   0                 337                 337                 248                 264                8604
      46                    0                   0                   0                   0                   0                 339                 339                 265                 279                8607
      47                    0                   0                   0                   0                   0                 342                 342                 285                 285                8609
      48                    0                   0                   0                   0                   0                 346                 346                 306                 287                8611
      49                    0                   0                   0                   0                   0                 349                 349                 333                 290                8570
      50                    0                   0                   0                   0                   0                 378                 378                 360                 292                8612
      51                    0                   0                   0                   0                   0                 387                 387                 402                 295                8615
      52                    0                   0                   0                   0                   0                 392                 392                 405                 300                8618
      53                    0                   0                   0                   0                   0                 395                 395                 408                 306                8620
      54                    0                   0                   0                   0                   0                 400                 400                 585                 325                8627
      55                    0                   0                   0                   0                   0                 459                 459                 615                 349                8644
      56                    0                   0                   0                   0                   0                 463                 463                 618                 391                8646
      57                    0                   0                   0                   0                   0                 469                 469                 665                 444                8651
      58                    0                   0                   0                   0                   0                 480                 480                1779                 504                8667
      59                    0                   0                   0                   0                   0                2599                2599                1896                 573                8709
      60                    0                   0                   0                   0                   0                2620                2620                2042                 575                8715
      61                    0                   0                   0                   0                   0                2854                2854                2145                 582                8744
      62                    0                   0                   0                   0                   0                2886                2886                2414                 590                8750
      63                    0                   0                   0                   0                   0                3041                3041                2850                 592                8748
      64                    0                   0                   0                   0                   0                6474                6474                3159                 595                8734
      65                    0                   0                   0                   0                   0                6675                6675                3379                 602                8698
      66                    0                   0                   0                   0                   0                6865                6865                3772                 616                8701
      67                    0                   0                   0                   0                   0                7495                6998                4351                 639                5675
      68                    0                   0                   0                   0                   0                7717                7001                6329                 642                5582
      69                    0                   0                   0                   0                   0                8469                7003                7019                 647                5804
      70                    0                   0                   0                   0                   0                8612                7010                7523                 657                6814
      71                    0                   0                   0                   0                   0                8615                7018                7777                 668                6817
      72                    0                   0                   0                   0                   0                8618                7027                7766                 681                6820
      73                    0                   0                   0                   0                   0                8654                7040                7759                 703                6718
      74                    0                   0                   0                   0                   0                8678                7053                7755                 733                6821
      75                    0                   0                   0                   0                   0                8856                7066                7753                 778                6804
      76                    0                   0                   0                   0                   0                8869                6939                7759                 863                6808
      77                    0                   0                   0                   0                   0                8874                6957                7770                 987                6821
      78                    0                   0                   0                   0                   0                8889                6967                7782                1196                6888
      79                    0                   0                   0                   0                   0                8894                6981                7802                1460                6898
      80                    0                   0                   0                   0                   0                8919                6984                7825                1812                6903
      81                    0                   0                   0                   0                   0                8931                6991                7854                2307                7005
      82                    0                   0                   0                   0                   0                8976                6993                7893                2885                7499
      83                    0                   0                   0                   0                   0                9010                6996                7943                3616                7013
      84                    0                   0                   0                   0                   0                9065                6067                7995                4476                7014
      85                    0                   0                   0                   0                   0                9116                6161                8056                5399                7497
      86                    0                   0                   0                   0                   0                9163                6327                7016                6058                7323
      87                    0                   0                   0                   0                   0                9190                6389                7019                   0                7362
      88                    0                   0                   0                   0                   0                9249                6535                6092                   0                7496
      89                    0                   0                   0                   0                   0                9246                6575                6108                   0                7472
      90                    0                   0                   0                   0                   0                9268                6752                6115                   0                7329
      91                    0                   0                   0                   0                   0                9271                6750                6119                   0                7421
      92                    0                   0                   0                   0                   0                9288                6788                5750                   0                7497
      93                    0                   0                   0                   0                   0                9287                6784                5759                   0                7436
      94                    0                   0                   0                   0                   0                9283                6775                5807                   0                7479
      95                    0                   0                   0                   0                   0                9285                6777                5883                   0                7498
      96                    0                   0                   0                   0                   0                9276                6743                5894                   0                7492
      97                    0                   0                   0                   0                   0                9277                6745                5890                   0                7975
      98                    0                   0                   0                   0                   0                6659                6659                5929                   0                7977
      99                    0                   0                   0                   0                   0                6671                6671                5929                   0                7984
     100                    0                   0                   0                   0                   0                6679                6679                5911                   0                7990
     101                    0                   0                   0                   0                   0                6688                6688                5904                   0                8043
     102                    0                   0                   0                   0                   0                6692                6692                5897                   0                8045
     103                    0                   0                   0                   0                   0                6697                6697                5899                   0                8088
     104                    0                   0                   0                   0                   0                6699                6699                5901                   0                8384
     105                    0                   0                   0                   0                   0                6703                6703                5903                   0                8343
     106                    0                   0                   0                   0                   0                6445                6445                5869                   0                8346
     107                    0                   0                   0                   0                   0                   0                   0                5873                   0                8348
     108                    0                   0                   0                   0                   0                   0                   0                5877                   0                8351
     109                    0                   0                   0                   0                   0                   0                   0                5878                   0                8362
     110                    0                   0                   0                   0                   0                   0                   0                5830                   0                8368
     111                    0                   0                   0                   0                   0                   0                   0                5485                   0                8392
     112                    0                   0                   0                   0                   0                   0                   0                   0                   0                8393
     113                    0                   0                   0                   0                   0                   0                   0                   0                   0                8382
     114                    0                   0                   0                   0                   0                   0                   0                   0                   0                8178
     115                    0                   0                   0                   0                   0                   0                   0                   0                   0                8223
     116                    0                   0                   0                   0                   0                   0                   0                   0                   0                8234
     117                    0                   0                   0                   0                   0                   0                   0                   0                   0                8245
     118                    0                   0                   0                   0                   0                   0                   0                   0                   0                8246
     119                    0                   0                   0                   0                   0                   0                   0                   0                   0                8248
     120                    0                   0                   0                   0                   0                   0                   0                   0                   0                8268
     121                    0                   0                   0                   0                   0                   0                   0                   0                   0                8752
     122                    0                   0                   0                   0                   0                   0                   0                   0                   0                8755
     123                    0                   0                   0                   0                   0                   0                   0                   0                   0                8757
     124                    0                   0                   0                   0                   0                   0                   0                   0                   0                8760
     125                    0                   0                   0                   0                   0                   0                   0                   0                   0                8763
     126                    0                   0                   0                   0                   0                   0                   0                   0                   0                8765
     127                    0                   0                   0                   0                   0                   0                   0                   0                   0                8768
     128                    0                   0                   0                   0                   0                   0                   0                   0                   0                8474
     129                    0                   0                   0                   0                   0                   0                   0                   0                   0                8479
     130                    0                   0                   0                   0                   0                   0                   0                   0                   0                8454
     131                    0                   0                   0                   0                   0                   0                   0                   0                   0                8468
     132                    0                   0                   0                   0                   0                   0                   0                   0                   0                8470
