   Depth            BFSolver                A(i)                A(c)           A(+{c,i})         A(+{c,i,4})    A(+{*{i,i},c,4})    A(+{*{s,s},c,4})A(+{*{B,B,s,s},c,4})A(+{*{B,B,a,a},c,4})             A(rand)
       1                    0                   1                   1                   1                   1                   1                   1                   1                   1                   1
       2                    4                   8                   9                   8                   8                  10                  10                  10                  10                  10
       3                   10                  25                  16                  23                  20                  46                  46                  28                  28                 545
       4                   17                  34                  21                  30                  26                  42                  42                  36                  36                 546
       5                   28                  74                  32                  45                  37                  57                  57                  57                  44                 540
       6                   46                 101                  50                  65                  52                  62                  62                  62                  47                 537
       7                   71                 155                  57                  79                  68                 147                 147                  64                  49                 529
       8                   99                 244                  64                  67                  56                 148                 148                  65                  50                 540
       9                  128                 316                  75                  76                  65                  66                  66                  66                  51                 541
      10                  152                 364                  84                  82                  71                  93                  93                  93                  66                 533
      11                  174                 423                  93                 105                  92                  86                  86                  86                  75                 520
      12                  200                 441                 104                 114                  96                  95                  95                  95                  74                 535
      13                  230                 381                 109                 117                  98                  96                  96                  96                  78                 530
      14                  261                 423                 107                 117                  98                  97                  97                  97                  80                 526
      15                  286                 456                 112                 115                  94                  98                  98                  98                  81                 528
      16                  306                 505                 120                 126                  95                  99                  99                  99                  82                 544
      17                  326                 514                 131                 132                 107                 122                 122                 125                 108                 548
      18                  346                 507                 140                 145                 125                 148                 148                 143                 126                 527
      19                  368                 515                 151                 151                 131                 149                 149                 144                 127                 540
      20                  389                 510                 157                 163                 143                 153                 153                 148                 131                 546
      21                  411                 513                 166                 168                 148                 153                 153                 148                 131                 548
      22                  431                 520                 167                 172                 152                 154                 154                 147                 130                 549
      23                  451                 526                 166                 170                 150                 155                 155                 148                 131                 548
      24                  465                 528                 170                 171                 151                 162                 162                 152                 135                 572
      25                  475                 544                 176                 178                 158                 166                 166                 154                 137                 555
      26                  487                 563                 182                 187                 167                 174                 174                 156                 139                 571
      27                  504                 561                 187                 193                 173                 176                 176                 160                 143                 572
      28                  520                 563                 189                 192                 172                 178                 178                 162                 145                 573
      29                  532                 571                 190                 192                 172                 179                 179                 163                 146                 568
      30                  540                 570                 193                 193                 173                 180                 180                 164                 147                 571
      31                  547                 566                 200                 203                 184                 182                 182                 166                 149                 572
      32                  553                 566                 205                 208                 189                 184                 184                 168                 151                 573
      33                  561                 570                 213                 207                 188                 187                 187                 171                 154                 577
      34                  571                   0                 222                   0                   0                   0                   0                   0                   0                 588
      35                    0                   0                   0                   0                   0                   0                   0                   0                   0                 609
      36                    0                   0                   0                   0                   0                   0                   0                   0                   0                 617
      37                    0                   0                   0                   0                   0                   0                   0                   0                   0                 617
      38                    0                   0                   0                   0                   0                   0                   0                   0                   0                 618
      39                    0                   0                   0                   0                   0                   0                   0                   0                   0                 618
      40                    0                   0                   0                   0                   0                   0                   0                   0                   0                 619
