   Depth            BFSolver                A(i)                A(c)           A(+{c,i})         A(+{c,i,4})    A(+{*{i,i},c,4})    A(+{*{s,s},c,4})A(+{*{B,B,s,s},c,4})A(+{*{B,B,a,a},c,4})             A(rand)
       1                    0                   1                   1                   1                   1                   1                   1                   1                   1                   1
       2                    2                   2                   2                   2                   2                   2                   2                   2                   2                   2
       3                    5                  14                   8                  14                  14                   5                   5                   5                   5                  29
       4                    8                  16                  12                  16                  16                   9                   9                   9                   9                  30
       5                   13                  20                  16                  20                  20                  11                  11                  11                  11                  40
       6                   20                  42                  23                  30                  30                  18                  18                  18                  18                  46
       7                   31                  62                  30                  37                  37                  19                  19                  19                  19                  47
       8                   38                  55                  35                  36                  36                  20                  20                  20                  20                2259
       9                   47                  71                  39                  48                  46                  36                  36                  36                  36                2252
      10                   52                  66                  44                  49                  47                  54                  54                 282                 286                2253
      11                   60                  87                  58                  69                  62                  56                  56                 284                 288                2254
      12                   76                 148                  80                 116                  87                 190                 190                 407                 411                2266
      13                  102                 221                 107                 162                 103                 192                 192                 408                 412                2267
      14                  139                 360                 138                 216                 160                 193                 193                 407                 411                2269
      15                  191                 548                 179                 260                 173                 194                 194                 408                 412                2269
      16                  266                 912                 216                 380                 211                 196                 196                 410                 414                2267
      17                  371                1283                 281                 456                 300                 199                 199                 413                 417                2387
      18                  500                1627                 316                 585                 393                 203                 203                 417                 421                2388
      19                  668                2117                 387                 770                 458                 207                 207                 421                 423                2397
      20                  851                2388                 427                 812                 626                 210                 210                 424                 425                2397
      21                 1062                2587                 490                 917                 706                 214                 214                 428                 427                2315
      22                 1278                2595                 545                 886                 738                 216                 216                 430                 429                2316
      23                 1498                2627                 617                 945                 789                 219                 219                 433                 432                2317
      24                 1704                2635                 646                 945                 789                 223                 223                 437                 436                3138
      25                 1894                2647                 677                 944                 788                 233                 233                 447                 446                3139
      26                 2053                2637                 721                 886                 738                 232                 232                 446                 445                3160
      27                 2203                2635                 766                 943                 787                 233                 233                 447                 446                3202
      28                 2315                2655                 825                 962                 804                 234                 234                 448                 447                3225
      29                 2411                2645                 859                 973                 814                 235                 235                 449                 448                3227
      30                 2493                2659                 950                 984                 825                 238                 238                 452                 451                3209
      31                 2580                2668                1011                 993                 834                 241                 241                 455                 454                3227
      32                 2662                2662                1121                 987                 828                 252                 252                 466                 465                3250
      33                 2756                2670                1199                 995                 836                 253                 253                 467                 466                3251
      34                 2771                   0                1203                   0                   0                 255                 255                 469                 468                3322
      35                    0                   0                   0                   0                   0                 255                 255                 469                 468                3328
      36                    0                   0                   0                   0                   0                 258                 258                 472                 471                3328
      37                    0                   0                   0                   0                   0                   0                   0                   0                   0                3319
      38                    0                   0                   0                   0                   0                   0                   0                   0                   0                3318
      39                    0                   0                   0                   0                   0                   0                   0                   0                   0                3328
      40                    0                   0                   0                   0                   0                   0                   0                   0                   0                3326
      41                    0                   0                   0                   0                   0                   0                   0                   0                   0                3315
      42                    0                   0                   0                   0                   0                   0                   0                   0                   0                3316
      43                    0                   0                   0                   0                   0                   0                   0                   0                   0                3315
      44                    0                   0                   0                   0                   0                   0                   0                   0                   0                3317
      45                    0                   0                   0                   0                   0                   0                   0                   0                   0                3311
      46                    0                   0                   0                   0                   0                   0                   0                   0                   0                3313
      47                    0                   0                   0                   0                   0                   0                   0                   0                   0                3314
      48                    0                   0                   0                   0                   0                   0                   0                   0                   0                3327
      49                    0                   0                   0                   0                   0                   0                   0                   0                   0                3105
      50                    0                   0                   0                   0                   0                   0                   0                   0                   0                3127
      51                    0                   0                   0                   0                   0                   0                   0                   0                   0                3137
      52                    0                   0                   0                   0                   0                   0                   0                   0                   0                3138
      53                    0                   0                   0                   0                   0                   0                   0                   0                   0                3139
      54                    0                   0                   0                   0                   0                   0                   0                   0                   0                3138
      55                    0                   0                   0                   0                   0                   0                   0                   0                   0                3136
      56                    0                   0                   0                   0                   0                   0                   0                   0                   0                3137
      57                    0                   0                   0                   0                   0                   0                   0                   0                   0                3139
      58                    0                   0                   0                   0                   0                   0                   0                   0                   0                3139
      59                    0                   0                   0                   0                   0                   0                   0                   0                   0                3138
      60                    0                   0                   0                   0                   0                   0                   0                   0                   0                3139
      61                    0                   0                   0                   0                   0                   0                   0                   0                   0                2957
      62                    0                   0                   0                   0                   0                   0                   0                   0                   0                2971
      63                    0                   0                   0                   0                   0                   0                   0                   0                   0                2968
      64                    0                   0                   0                   0                   0                   0                   0                   0                   0                2971
      65                    0                   0                   0                   0                   0                   0                   0                   0                   0                2970
      66                    0                   0                   0                   0                   0                   0                   0                   0                   0                2971
      67                    0                   0                   0                   0                   0                   0                   0                   0                   0                2971
