           #####
 ###########   #
 #     $    ...#
 #$$#  #####...#
##  #$ #   #...#
#  $   #   #...#
#@#$$ ##   #...#
# $    #   #...#
##  $$ ######.##
 # $ $ #   #   #
 #$ $ $ $ $    #
 #  ## #  $$# ##
 #     ###    #
 ####### ######