   #######
   #  @  #
#### # $ #
#...$#$ ##
#... $   #
### $ ## #
  # $    #
  #    ###
  ######