    ########
    #      #########
##### #### #@##  ..#
# $  $           ..#
#   # ### #####  ..#
### # ### #   ######
  #  $  $ #
  ###  $###
    #$  #
    #   #
    #####