      #######
     ##@#   #
    ##  # $ #
 ####  # $  #
 #    # $ # ##
 #   # $  #  #
 #  # $  #   #
 # # $  #    #
##  $  ### # #
#  $  ##...# #
#   ##.....  #
########  ####
       ####