  ######
  #....#
  #  ..#
###$$#####
# $   $ @#
#   $ $  #
###   ####
  #####