############
###..##    #
##....#  $ #
#.....# $# #
####.. $ #@#
#   ..# ####
# $# $#    #
#  #  #  $ #
#   # # $ ##
# $$$ # ####
#   $ #    #
#### ## $$ #
##   $   $ #
##     ##  #
############