###########
#     # @ #
# $  $  $ #
## #...# ##
 # #...# #
 #$ ### $#
 #   $   #
 #  ##   #
 #########