########
#  ##  #
#  ##$ #
#  $   ##
## #    ##
 # ## #  #
 # $ $## #  ####
## ##    ####..#
# $ #$ #$##  ..#
#      $     ..#
########@##  ..#
       #########