########
#.   $ #
#.$  # #
#.# #  #
### # ##
 # $  #
 #@ ###
 #####