  #####
  # . #
###$ $###
#  $ $  #
# . . . #
### * ###
  # * #
  #$.$#
  # . #
  #$.$#
  # + #
  #####
  