    ####
#####@ #
# $ $$$##
#  .#.  #
## #  # #
 # . .  #
 #   ####
 #####
 